***************************************+**********************++++++++++++++++++++++++++++++++++++++++++++++++++++++++++++++++++++++++++++++++++++++++
***************************************+********************++++++++++++++++++++++++++++++++++++++++++++++++++++++++++++++++++++++++++++++++++++++++++
**************************************+*******************+++++++++++++++++++++++++++*###++++++++++++==+++++++++++++++++++++++++++++++++++++++++++++++
**************************************+******+=+**++******++++++++++++++++++++++++*#*+*+##++++++++++++++++++++=+++++++++++++++++++++++++++++++++++++++
******************+++****************++*****++=+=+==+***++++++++++++++++++++++++++*%++==+##+++++++++++++++++++=+++++++++++++++++++++++++++++++++++++++
******************+++****************+******+=======+**++++++++++++++++++++++++++++##+*++*%*++++++++++++++++++=+++++++++++++++++++++++++++++=+++++++++
*****************+++++***************+******++=+===+++++++++++++++++++++++++++++++++###%%@%%+++++++++++++++++=+++++++++++++++++++++++++++++==+++++++++
*****************+++++***************+********++++++++++++++++++==%******+++++++++++#%%@@@@%#++++++++++++++++=+++++++++++++++++++++++++++++===++++++++
+******************+*****************+*****+++++++++++++++++++*%++#**#*+#++#**++++++*%%@@@%%%+++++++++++++++++++++++++++++++++++++++++++++++++++++++++
+++++*******************************++****+++++++++++++++++++%%%%#%###*****+**%++++++*%%%%%%++++++++++++++++++++++++++++++++++++++++++++++++++++++++++
++++++++****************************++**+++++++++++++++++++++*#+*%**%%%%%%%%#%%+++++++***%%%*+++*##*++++++++=+++++++++++++++++++++++++++++++++++++++++
++++++++++++***********************+++++++++++++++++++++++++*%*+##**%%%++#*+#%%#+++++++++#%%#*#%%%%%#+++++++=+++++++++++++++++++++++++++++++++++++++++
+++++++++++++++++++++++++++++++++++++++++++++++*#****#++++++%%%%%%##%%#++%**#***#++*+++++#%%%%%%%%%#++++++++++++++++++++++++++++++++++++++++++++++++++
++++++++++++++++++++++++++++++++++++++++++++++*%%*+++#*++++#*+*%**%##%%%%%%%%*+#++*#++*%%%%%%##++*%+++++++++++++++++++++++++++++++++++++++++++++++++++
++++++++++++++++++++++++++++++++++++++++++++++*%%%=+++#++++%++#*****+#++#%%%##%%%%%%%%%%%%#++*+===###+++++++++++++++===+++++++++++++++++++++++++++++++
+++++++++++++++++++++++++++++++++++++++++++++++#%%*+***++++%%%%%%#***#++%%%#**#**%%%%%#*++#*==++++**#+++++++++++++++++++++++++++++=+++++++++++++++++++
++++++++++++++++++++++++++++++++++++++++++++++*#%%%*+++++++*#%#%%%%%%%%%%%%#*#*+*%%%%%%#*++%++*##***++++++++++++++++++++++++++++++++++++++++++++++++++
++++++++++++++++++++++++++++++++++++++++++++#*++#%%#++++++++#+***+++#*%#+*#%%@%%%%%++#%%*+*##*++++++++++++++++++++++++++++++++++++++=+++++++++++++++++
###%%%%%##**++++++++++++++++++++++++++++++++#++**%%%*+++++++%++===++#+%***%#*+##%#+==++**==*#++++++++++++++*#*#*++++++++++++++++++++++++++++++++++++++
%@@@@@@@@@%%%%%#*++++++++++++++++++++++++++++##*+#%%#++++++*#++===+***%+**##**%+%%#+*+-+*#%#++++++++++++++#*++=+#++++++++++++++++++=++++++++++++++++++
@@%%%%%%%%%%@@%%%%%#++++++++++++++++++++++++**+++*%%%+**##*##*+++++*+##+*+=+****%%%%#*+#*++++++++++++++++#++=++#*++++++++++++++++++=++++++++++++++++++
#**++++++**##%%%%@%%%%%*+++**##*++++++++++**+===+*#%%%#++++++*%%%##*+%******+#+####%%%%##*++++++++++++++%%#++*%*+++++++++++++++++++=++++++++++++++++++
+++++++++++++++*#%%%@@%+*******+#*##*+++++#+===++**%%%**++==+#%%%+++*%+=+***+#+#+***+++++%*++++++++++++%%#+%%#*#%#*+++++++++++++++++++++++++++++++++++
+++++++++++++++++++*#%#+++=--=*+%*%%%#***%%###**++#%%%%##+**+%%%*+++##+++++=*#+*+*+===**+%#++**%#+****#%%######+**+++*****#+++++++++++++++++++++++++++
+++++++++++++++++++++#*+********+**+++**###%%%%@%%%%%@%%%*+++%%%*++*%*+****+#*+**====++*+%*+***%+******%#++++##+***********%++++++=+++++++++++++++++++
+++++++++++++++++++++*%%#*+++++*+**=--====++##%%%%%%%%%@@@@%%%%%#*+#%%@@%#*+%+*++******+#%++=-#%+--=++*%*+=++%****+++*******++++++=+++++++++++++++++++
++++++++++++++++++++++++****###++*##*+***+++*+#%%%%*+%#*#%#%%%%%%@%%%@@@@@@%%*%%%*+*+**+%#+**+##+***++#%*+=*+%+****+++***+#++++++=++++++++++++++++++++
+++++++++++++++++++++++++++++++++++*#+***+##+++%%%#+*%**##**%++#%%@@@@@@@@@@@%%%%%#**%%%%%%##*%#+++**+#%++++##+**********+#++++++=++++++++++++++++++++
+++++++++++++++++++++++++++++++++++++#%%###++++#%%%%%#%%%#*##++%%%@@@@@@@@@%%%%%%%%@%%%%%%%%%%%%%%%%%#%*++**+**##**++++**+#++++++=++++++++++++++++++++
+++++++++++++++++++++++++++++++++++++++++++++###%%%+*+#%=+#%%%%%%@@%%%%%%#*********####%%%%%%%@%%%%%%%%*++++++==*+*#%#####++++++++++++++++++++++++++++
+++++++++++++++++++++++++++++++=++++++++++++*****%%%%%#%**+#%%%%%%%##%%#+++++++++++++++++++**##%%%%%%%%%%%%%%#***+=*#+++++++++++++++++++++++++++++++++
+++++++++++++++++++++++++++++++=+++++++++++++%%#*#%%****%%%%%%%*+++++%%%#++++++++++++++++++++++++*%%%%%%%%%%%%%%%%%%%%%###*+++++=+++++++++++++++++++++
+++++++++++++++++++++++++++++++=++++++++++*+*#***#%%%%%%%%%#*++++++++%%*=*+++++++++++++++++++++*#*++++++*#%%%%%%###%%%%%%%@%%%%%*##***++++++++++++++++
+++++++++++++++++++++++++++++++++++++++++#*==*#*+*%%%%%%%*+++++++++++%%*=*++++++++++++++++++++*#+**********+*%%%++++++++*##%%%%#%%%%%%%%%%%%%%%%%%%%%%
++++++++++=++++++++++++++++++++++=++++++++*%*****+#%%%#+++++++++++++#%%###%%#######%%%%#*++++**+********+++***+*%#++++++++++++++++*##%%%%%%%%%%%%%%%%%
+++++++++==+++++++++++++++++++++++++++++*#******%%%#*++++++++++++*#%##%###################%%%#+++++++****+++****++#*+++++++++++=++++++++++++++++++++++
+++++++++==+++++++++++++++++++++++++++**+**+*#%%%#++++++++*##%#######%%#################################**++++****+*#++++++++++=++++++++++++++++++++++
++++++++++++++++++++++++++++++++++++++#**+#%%%%*++++*################%%#####################*###################*+*+#*++++++++++++++++++++++++++++++++
++++++++++++++++++++++++++++++++++++++=#%%%%#*+++*#%#############*++====++*#################*######################+#*++++++++=+++++++++++++++++++++++
++++++++++++++++++++++++++++++++++++++++*#*+++++#%###############*++=---+**#########################################%*++++++++=+++++++++++++++++++++++
+++++++++++++++++++++++++++++++++++++**+++++++*############################################*#######################*##++++++++++++++++++++++++++++++++
+++++++++++++++++++++++++++++++++++**++++++++*%########################################################################%#*++++++++++++++++++++++++++++
++++++++++++++++++++++++++++++++++*++++++++=######################################################################*#######%#+=+++++++++++++++=++++++++
++++++++++++++++++++++++++++++++*+++++++++#%################################################*+*##############################++++++++++++++++==+++++++
+++++++++++++++++++++++++++++++#*+++++++*%#####################%%%###########################+#################################+++++++++++++===+++++++
++++++++++++++++++++++++++++++++++++++*%####################%%+++*%###############################*#############*###############++++++++++++++++++++++
++++++++++++++++++++++++++++++*++++++*%########*#*****##%%%#*+++++#%##%%##%%%###############################*#*##################+++++++++++++++++++++
++++++++++++++++++###%%%%##++#+++++++%######%%#*******+++++++++++*%##%*++++++*%%##################################################++++++++++++++++++++
++++++++++++++++++%++=-=++#**+++++++%#######%++++++*######*+++++#%##%*++++++++++*#%%######*+++*###%%###############################+++++++++++++++++++
++++++++++++++++++#++===++%**+++++*%########%*++*#%%%%%%%%%%%%%%####%#++++++++++++++*#%%%%%%%##***++*%%#############################++++++++++++++++++
++++++++++++++++++%%%%##**%*#++++*%###########%%%%%##################%++++++++++++++++++++++++++++++++%##############################+++++++++++++++++