                            ..                 . ...................::::::::.-=-::::::::::::::::::::::::::--:::::::::---=------::------------:--------
                                 .             . ...................::::::.:..==-::-::::::::::::::----:-:::::::-:-::::::::::::------=======+-:-:::----
                                     ...           ....................::::::..==::::::::::::::::::::::-::::..::::::::--:::-==+=-:::--::::::--:::::---
                                           ..      ....................:::::.:.:==::::--:::::::::.........::...:-:::::::--:-==-:::..::::::::::-==-:---
                                               ...    ..................:::::.:.:=-..::-::::::::::::............::..::::::::::......:::--::-----------
                                                      ..................::::::.:.==:...:-----::::...:.::.........:::::::::::::::.::::-----:::----=-:--
.                                                     ...................:::::.::.==:...:---::::::.:::::::::..:::---:::::.:----:::-----::::-:-------=-
.........                                        .     ..................::::::.:.:==.......::......::::::-:::::---:--:::------:-=-----------:---===+=
.................                              .        . ................:.:::..:.:==....:::.:::::...:::::::::::--------==-----==----=----:==-::::---
........................                             .........................:::.:.-=-..::.:::::.::...::::---::::::-:--===+===-=+=-::---=::::--:....:
...............................                   ...........................:::::.:.==:....:..::::::.:....::---:::..::-----:::::-=--:..:::::::-:....:
..............................                  ...............................:::..:.+=......:....:.:::::....::-=:..::--::::.....::::.:::::-:--:::---
..............................                   ............ ..............:::::::.:::+=..............::::.....::....:.........:....::::::::....:-::-
   ...........................                  ............................::::::...:.-+=....:.......::----::.....-:--:::......::::...::-::-::.......
           ...................                    ..............................:.:::.:.=+-....:..........---:::::.::.......:::.:-::.:.....:--::......
                   ...........                     ................................::::::+=....:............::.............:...:--:-:..:..::.::::::...
                           ...                       .......  . . ...........:::::::.....=+:....:............::--:::.......:.:..--:::.................
                                                     .......     . ....::::......::::-::.-+-...............................::-::--:-:.................
                                                       ...   ..............::::::::---:::-+=...............................:..-:--:-::....:...........
                                                               ...........::::::::::---:::++:........ ....................::..::=-:::::.......:.:.::.:
                                                   ..    ...................::::::-----::.=+:............................:::.:::=-::...........::.:...
                                                   .... ....................::::::::---::.-+-..................:.....:...:::...:-::--.....::..::::::::
                                                   ..............................::::---:::+=...................:..........:...:::.-:.....::..:--:-:::
                                                   :.............................::::---:::=+......:...........::.......:.::...:=::-:....:::...-::---:
                                                   :.  ..........................::::-----.=+:................:-:...:...:.::...:=-.-:.....::.:---:-:::
                                                   ..   .......................:::----==--.=+-................:::........:::...:=-.-...::.-:..::-----:
                                                   :.    ....................::::::::-----:-++.....:..........:-:.........::...:-:.-......-:..:--::---
     .       ..........                            :.    ....................::::--------:::++:...............:-:.......:.-:.::::::::::::::::::::::---
     .                .                    ..:::::::.        ...... ...........::::::::----.=+:.......::....:::=:.:::.....-...:::::::::::::::::::::---
      .................                ..........:.::....      .................::::::-----.=+=:::.::.......-::-:.........-...:::::::::::::::::::::-:-
                                      .  ..........:....:...       ............::::::::::::.:----+:.........:::-::........:...:::--------:::::----::::
                                      .   ......::::. ..:          ...........:::.::::::::::::---+:.......:...--::......:.:...:::--------:::::----:-::
   ...                .               .   ....:::::.:...:. ..     ..........:.::.....::::::::----+::......:...=-::.....::.:...-:---------:::::----:-::
:::::.---------:-------:-------------::::::-::---::::::::...................:.::......:::::::-:--+::.:....:...=-::.....::::...-----------::---:::::::-
:::::.::::::::::::::::::--::----:=---:---:----==---------============-+==+==++*++++*+****+********+++++===:.::=-::.....::::...-----------::----::::-.:
:::::.::::::::::::::::::---:----:=---:=--:----=--:==--==-=====-====+=-++=+=========*+*+*++*+*+***********+-.::=--:.:....:.:.:.-----------::----:-::--.
:::::.:::::::::::::::::.::-:----:----:---:-------:=---==-==========+=-+==++-=======+++***+*+*+*+****+*+*++=-::=::-.:....:.:.:.--:::::::::::::::::::::.
.::::.:::::::::::::::::.::::----:----:---:-------:---------=---===-==-+=-+=-=======+=+++++*+*+*+****+++*++++-==--:--::::-.: ....::.-:: ...:.:..:::::::
.::::.:::::::::::::::::.::::::--:----:---:---:---:---:---------===-==-==-+=-=======+=+++++*+*++++**+++++++++=+=-=====--=-:-:::..::.----:..-:--::::::--
.::::.:::::::::::::::::.::::::--:---::--::--::---:---:--:------===-==-==-============+++++*+*++++++++++++++=+===++++=======--:::--:----:::::-..::..::-
.::::.:::::::::::::::::.:::::::::---::--::--::---:---:--:---:--===-==-==-+=-=-==-====+++++*=+=++=-++++++++++++++++++++++++=====-=====-::::--:::-::::::
.::::.:::::::::::::::::.:::::::::---::--::--::---:---:--:------=-=-==-==-+=-=-==-====++++=*=*=*=:-+++++++++++=::++++++++++==========---------::-------
.::::.:::::::::::::::::.:::::::::---::--::--::---:---:--:------===-==-==-+=-=-==-====+++*+*+*++=:=++++++====+-:-++++++==========---------======----==-
:::::.:::::::::::::::::.:::.::::.---::--::--:----:=--:--:----=====-==-==-+=-=-==-=-==++=+=+=+=====+==============+======----================--::::::::
:::::.:::::::::::::::::.:::.::-::---::---:--:----:==-:--:=---=-===-==-==-==-===-----================================================--:::---------::::
:::::.:::::::::::.:::::.::-::--::---:::-::--:-----=--:--:---:-----:-------------------==============++==++==++++++++======-:::::----==--.-:::::::::::.
:::::.:::::::::::::::::.:::::--::---:::--:--:::--:---:--:--:------------------------================+++++=======---::::----:======-----:.::::::::::---
:::::.:::::::::::.:::::.::::::::::-::::::::::::::::-::--::------------------------======================-::::::-==.----------=--------::::::----------
:::::.::::::.::::::::::..::.:::::::::::::::::::::::----------------------------============+==---::::-=======-----.--:::.-:----:---:-----------------:
...............:....::..::.::::::.::::::::::::::::--::-----------------=======---==-----:::---==========-=-------:.:::::.:::-------------------------:
........:............::::::::::::::::::::::-:::------:::--------------------:::::...:--========--------=--:------:..::::-------------------------:.::.