                 .    ......::...................::::::::::::::::::::----:--:+#*===+=========------==++=-=+++==-====+++*#****#*#*#****#####*+*###+++++
                  .....   .   ..:::.............:::::::::::::::::.:::---:::---##+==+========------==+++*===+++**=*+=++++*******##***#%#######****+++++
                   ......    ...... .:::.......:::::.....::::::::::::.:-----=-:##++========-------=++=+**+===-++++++++**+++*###########**#*****+++++++
                  .........  .....  .......:::.....:....::::::::.::::::-----:-:-##==+++====-----=======-===+===++++=++***#**#####***#*#*##*+****#**+++
                 ................    .........:::::.....::::::::::::::::------=:=#*--+++============------:::::=+++=+==+*++++*++#**********#*#####*+++
               ................   .  ....................::::::::::.::::--=-----:*#+---=======++=---::----:::::-=*+=------=+==+++*****++*+++*#+**#+*++
:::...        .................  .   .......:.........:..::.:::.::::::::----------##=--===+++=====-==+*+=++-:--=++*+-=-==-=*++++*#****++=++#++*+***+**
-:::::::::........ .............    ...................:.....:::..::::::----------=##-----------==---=++==++++==***=+++=+++*+*+=##***++**+**#***##%###
::::-----------::.. ..............  ....................:..........::::::-----=--=-=#*:::-----:--=--:---+=+*++++-+*******###***+*#******+**####*##%##*
::::-------------------::.......... .....................:........::::::::::-------:*#+---=--=====++::::--=+*#*###*****#*##%###%%%%##****#*##*##*#**#*
::::--------------------------:...........................:......::::::::::---------:*#=::--========----:::-+**#*+++=++**+*##########++*#****###**#*#*
::::--------------------------.............................:.....:::::::::---------:-:##:::::-========+==--:--+**#---==**=+++-=---+***+*****#*####*##*
:::::-------------------------..................................::::::::::---------:::=##-:---------:--====----=+++==++=+-=----=##====***=+**+***#****
..:::::----------------------:..................................::::::::::--------:::-:+#*::--+=--::--========----=++=--=+=+---=#*==--=-+*=+********+=
...........::-----------------................................:::::::::::::-------::::-:*#*:::-===-:--:-====*+--=--=----:::=++=-#*=+=*+**+-=+**++*++=-
....................:::-------................................::::::::::::::::::::::::---##-::--=---:-::-==+**+==-----::==-=::=-#*=*=--+=-==-===+===--
............................::................................:.::::::::::::-------::..::##=::::::::-::---=-=***++++-------=--:-#+=+=:::-::--------::-
................................................................::.:::------:::::::-----:*#+:::...::::::::---==--=-==-=+---=-+--#*=*=:::--++=-----:--:
.............................................................:::::::::::::-----------=-:-=##:::...:::::::::::=-::::::-=-==-+:-+-#*=+==:-=-=--:--:--:::
...........................................................::.:::::::::::--------::--=-:--##-::...::.:::::::=::::-::::::---*::==**=+==--=-=-:---=-----
...................................................-:.....::::::::::::::::-:::-----==++:-:##=::::..::.:::::::-:=-::::---==-+:--=**--:---::=::::-=--:--
................................................ ..-:....::::::::::::::::::::::------==:-:+#+:::...:...::::::.:=::::--:----=::--*=-*+-::::=-:-==-=-=-=
...................................................-:...:::::::::::::::::::::::::::--==-::=#*:::..::::.:::::::::=:::::::::-=:::-*+-*=:::--+---=++-+-=+
...................................................-:..::::::::::::::::::::::::::::-----::-##:....:=:::::::::.:+=::-:::-=-=+===-*+-#=-::--*-::-+=-*++=
...................................................-:..:::::::::::::::::::.......::---==--:##-::.::=-:::..::::-+=:::=-::--==:---*=-#=:::::*=:-**+=+===
...................................................-:..:::::::::::::::::....:::::----=++--:*#+...::--=::....::-+=::::--:-===:::-*=-*-::--:*-:-==+=*++=
...................................................-:....:::::::::::::::....::::::----==-::+##....:-:==-:::.::-+=::::--==:=-:::-*=:*-:::-:*=--=**+****
..............::::::::.............................-:.....::::::::::::.....:::::---------:--##:::...:-==-.::::=++===-:::--=-:-+++++++++++++++++*******
.....:................:....................:--------:......:::::::..:.........::::::::::::-:#*-:.::::-=+=:::-:=+=:-=-:::--=-:-++++++******************
..........:::...:................... .::::---------==::::......::..............::::::::--::.+*=:::.-=:-=-:::=:=+-:::::::=:=::-++++**************##**++
.. ..... ...............  .........  .:...:-.....:---:-:=:....................:::::::::::::.::::-*:...:::.::--==--::::::=:=:::+**%%%%%%%#*****#%%#*++=
   .... ............. .. ......... ...:  .:-...:--==:...-.....................-:-:::::::::::::---*::.:.:..::::==:-..:::-=:-.::+**%%%%%%%#*****#%%#**++
::::.:............... .  .......   ...: . :-::--===:=:.:-:....................-:..:...::...::::--*:.......-..:+=--...::-=:-..:***%%%%%%%#*****####***+
*****=######*####*#####*#######******+*++=+++=+*++==-===-::::::::.....:.......::...........:::--=*:......:-..:+=--....:==--..-**##%%%%%%#**#%%*****+=*
+**=*-#+#**#**##*+#*#**=*#*+#*#*+##**+**#=**#*###+##***#*######******+#**#**#*##*#*#*##*#********#***+++=*-:::+=-:.:..:==--.:-+*#####%%##**%%%******-+
**##*-**##***#*#*+#****=#*#+###*=%###+##*=###*###+###*##*#####*###*##+##*#**#*##+#*#*#***+**#*#*##########-:-:+==-.:..::=:-.-:+*#########++#%%*******:
+***+:**##**+**#*+#**#*-**#+**#*=####+##*=###**##+###+##*#########*##+##*##*#*##+#*%*##*#*#*#+#*%##**#*###+=--+--=.-:.::-:-.-:++++++++++++++++*****++:
+***+-*****++****=*+***-***+****=###*+#**=*#*+*##+###+##+#*#***###*##+#*+##+#*##+#+#+##***#*#+#*####*#*#*#**=+*-+-==:---=:-.:..:==:*-=..::=:-:-==+*+++
+***+-*****++****=*+***-***+****=###*+#**=***+***+###+*#+#******##+#*=#*+#**#*##+*+#+##***#*#+#*###########****=+*+**++*+=+=---:==-*+*++-:+=**++==*+**
+***+-*****++***+=*+***-**+=****=****+***=**++***+##*+**=#**+****#+**+*#+#**#*##+*+#+#**#+#*#+#*#*###%#%###**++*#########***+===+*=*+*++=-==*=-*=-=+**
+***+-*+***++***+=*+***-**+=****=****+***=**++***+##*+**=***+*****+**+#*+#**#+#*+*+#+#**#*#+#+#*=-*##%####%#%*##############*****#####+++***+++*+++***
+***=-*+***++***++*****-+*+=****=****+***=**++***+#**+**=***+****#+**+#*+#*+#+#*=#*#*##*#*#*#+%+:=*#*##**####+::####################******##*++#*****#
+***=:*+***++***+=*****-+++=****=****+**+=**++***=#**=**=***+**#*#+**+#*+##+#+%#=#+#*##*#*#*#*#+-+######****#==+##################*****##############*
+***=-*+**+++***+=#****-+**=****=##**+***=****###+##*+*#=#**+#####+#*+##+%*+#+*#+*+**##*#*#*#******************########*******##############*++==++**=
+***=-*+**+++***+=#****-***=+***=###*+***=##**###+##*+#*+##*+#*###+##+##+#**#***+*+**********************#**********##############**++++-+**#####****+
**#*+-****+++**++=#****-***=*##*+###*+*#+=##+*##**##*+*#+*#+++****+*****+**+**+*+++*********************################**+=---=+*******-**+==****++==
*###+-**##**+****=#**+*-**++***++#*#*+**#=***********+********************+********************###############**+==---=+***=***********+-==++++++++*##
*##**=**#********=*****=+**+++**+*#**+***+***+++**+*++*******************************#*##############**+=-----=+**:********+******#****+==++*#########
****+=*+**+*++++++*++++=+*+++**+++++*+++++**************************++********##############**==----=+************-**=+=-*+********++*################
==++=++++++=+++++==++++++++++++++++++++**+**************************############*#**++=----==++******************+-+==-=-=-+*+**###################*++
=-===+++*++++++++++++++++++++++++++++******#***************##############**+-:::::::=+********************+******=:--===+######################*+==+=-