                          ..  .. .                           ................... ....  .. ..               .     .             ..............         
                              ....                           ......................    ...                ..                 ................         
                              ...                             ......................  .    .              ....              ...--:...........         
                               .      ..                 .........................:.:..............     ........        .   ...:::........... . .     
                                    ........................................::::.----..:::.................................::.................  .     
                    ............     ......................................:--:-:-::------:............................:..::.  ..............   .     
                           ....:.... .......................................:--:::::-.:-:-................................................... ...     
                           .    .:...............................................:......................................  ..... .................     
            .....       ....         ...............:...:..:.::::.........................:...:.:.:.:::........................-.................     
            .....      .....      ..................:...::.:.::::::::::::::::::::::::::::::::::::::::::.....................:---.....   .........     
            ...       ......       .................:...::.:.::::::::::::::::::::::::::::::::::::::::::.....................--:.....   ..........     
            ...        ........ ....................:...:::::::-:::::::::.:-::::::::::::::-----::::::::.....................-.. ....      .......     
      ..    ....         ...............................:.:::::-::::::::::--:::::::::::::::::::::::::::..............................  ..........     
    ....    ....          .. ...........................:..::::::-::::::::--::::::::::::::------:-:::::....................... ......  .. .......     
   .....    .....         ..       .....................:..::::::-::::::::--:::::::::-::::-----::::::::..................  ..  ....... ...... ...     
   .....::::.....         ..      .... .................:..::.:---:::::::::-:::::::::-::::------:::::::..................... .........    .......     
  ..  . ...:.....        ....    .......................:..::.:------::::::-:::::::::--:::-:---::::::::........................ .................     
   .. ......::::.          ... .........................:..::.::------::::--:::::::::--:::-:---::::::::........................ .............         
........:---.:.::::.      ..............................:...:.::------::::---------::--:::------:::::::........................        ......   . ... 
...........-.:.-:::.      .... ............. ...........:.....::-----=-:::-=-=-=----:--:::------:::::::.................... ......   ........ .... .. 
         ....:...::...    ..     ......................::..:..::---------:-=---===-=---:-:------:::::::...................................... . .  .. 
          ....:::.:::.   ...      .... ..... ..........::..:::-----------:-=--------=-=:-:------:::::::.......................  ..................... 
          ........:.:.   ...    ............ ..........:...:::-==-=-==---:-=--=+++=---::---------::::::.............:...........::::..................
          ..................... ............ .........:::.::::+******#*==-===+******##=--:-------::::::.............:.........::::::..................
          ....................  ............ .........::::::.:=*#%%%%%%+=-++=+######+++++==-=-=----::::.......::-::::::......:---:::.:. ............ .
        . ....................  .:::........ .......:::--:......=#%%%%%==-=+==-==+*-=+**#=+-+=+-=-*----.::.:++=:......:.......===:...::...............
     ....            .............::..:..... .......:::--.......:+#######****=--==-==#***=#++=*==+*----.::.:===:..:::::::.. ..---....::...............
     ....            .........  ...:........ ..........--.........-:::...-+:.=+=*#-:-*=+*=#+++*==+*--=-.::.:==-....:.::::.. .:::-....:: ..............
   .......          ........... ...:........ .. .......--::......:-====-::-==-=++*--+*+=-=#=+=*-=+*----:.:.:==-......::::..  .......... ..........    
  ........         ..........   ...............  ........................::::...::--:--:.-*===+--=*----:.:.:=-:............  ........................ 
   .......         ...  ..  ..................  ........... ............................::+-=-=--=+----:...:--:............  .....................   .
     .....       . .. ...  .......:.......................  .......................::::.-:-:--=:-=+-:--:.:.:--:...........===+==--:................. .
     ..... .    ..........................:..  ...........   ...........................-.::---:--=::--:...:--:..........=+++==-::.................. .
   ..........:...............................  ............  ...........................-.::::-:--=::--:...:-=-======----++===--:................... .
.............................................  .........................................:..::::::=+----:..=+*---=+=-::....:=---:......................
..............::.....................:.......  .........................................:..::::::--:=---+**=-:::......................................
.........:.....:....:........................  .........................................:...::::::-:-:::+=++................................::........
........................................:....  .........................................:...:::.::::::::----:..............  ...   .::::::..::........
..........  .............:.................:..........  ............................:::::...:::::::-====:::-::. ...........   ..  .............. .....
.......... ...........::::..............:..:.............................:::::::::::::::::::::::::::-=---...:-:.. .........  ...  ...........    .....
......................:::..::..........::.:.......:..:::::::::::::::--------========-----::::::::::::----::..::............  .........................
......................:::::::...........:::..::.::::::::::::::----====::::-+++++***++++++========-...:::....:.::...............................   ....
..............::......:::::..........::...::::::.....:::::::------===-----==+++=++===-----===---:::::....::.:.::... .......................:-----:.::.
......................:..................:...:::::::::::----------------------======------------:....::....::...........    ..............==-:::::..::
..........................................::.....::::::::-------------------------------------:::::::::::......:::.....::::::::::::...::-:==::::::....
....................................:.............:::::::--------------------------------------::::::::::::::::::::::::-:....::::..:.====-==::::::..::
.........::-........................:.........:::::::::::--------------------------------------:::::::::::::::::::::....:---::.......::-:--::::.....:.
.........:.............::::.:::....:::::::::::::::::::::::::::::::::::::::::::-:--------------::::::::::::::::::::...................::...:...........
..................................::::::::::::::::::::::::::::------::::---------------------::::::-----:::::::::::::::::::::::::::::::::::::.........
..........::.......::::::::.::::::::::::::::::::::::::::::::-----------------------------------------------------------:::::::::::::::-:::::::::::::::
...................::.......::::::::::::::::::::::::::-:------------------------------------------------------::::::-----------------------------:::::