++++++++++++++=+++++++++++++++***+==========================
+++++++++++++++*******+++++++****++++++++++++===============
*****++++++++***********+****####************+=+++==========
****+++++++++++===------------=-:::::::::::::-++============
****+++++++***+=-======---:---=-:--------:---=+*++++++++=+++
**+*****+++**#+===-=======--+  +:--:--::::--:-#####*****+*+*
%#**+**#*****#+=====+*--===-==--:-==#+==+==+++%%%##****+****
%%##**%%%@%#***++==+==++*++**+=-:+=*-+#+***#**@%@%%%*=*+****
%%#*##%%%@%#*#%+#++==+++####*#=-=*##+-:*##%#%#@%@%%%**++***#
%%####%%%%%###%*#*****+#####**===#%##:.*####%#%%%%%#*++=+*++
%##*###%#%#####**++++*++**+=-=---+*#*=*=+****+%%#%#*+++=+===
+*+*+**++*+++*++++=-=====+==----::----:::-:::-*+===--------+
====+++++*+++*+*+===-=--*+===----- =-...-=-:.:*==----:-:----
-----=+++*+***=:-===--===+=::=+-.::+-:-:.--:::+==-:.:----:::
++*+++**+--=+*=++-=-===*+==+=--:--===::-=::--:++==-:::::::::
++:::--=-=+++#+**+=+=*+++++**+=- +=++==*++-=--=-:--:.....::-
+=-----=-===+*-==-=====++=+*****=**++====-:---=-:-:::....:.:
=-==---+-====++######******###*****#*****+++====---:::::.:.:
+-==-:----===++++********##%###**##%#*+++=+=+==-=-----::::.:
=------=-======+++++++++++***##*#**#**+*+**===---:::-:::::.: