::......   ........                         ................
......        .....................             ............
...                 ..........:::.....          ............
..                .....:::---=====-::....      ......:::....
                 ..::---===++***++===-:....    ....::::::...
              ...:--=++======+**++++===-:...   ...::::--:...
             ..::-==+++=======++=++===+=-:...  ...::::---:..
           ..::-==++++=+==-=--=========+=-:..       ..:---:.
    . ..  ..::-==+++++==--:-------------:-::.  .....:::----:
       . ..::--========--=+***++++==---:---:.    ....::----:
         .::--======-==-=+**+***+++===-:---:.    ...:::---::
        ..::--=====-===-=++++*#*++*+=--:--::.......:..::---:
        ..:::--========--+++++++==+=--::--::.. ......:.....:
        ...:::---=-----::.:::-:-=::--:....:............::::-
        ....::::::::::::.....:.::.................. .:::::::
        .......::::..............  ...... .................:
          ......................................... .....::.
      . .......::..-:.....................................:.
    .   ......::.-.:.:..:::::::::::......::..............:..
.. ........:::...:::-:::::::::::::::--::::...............:..