***************+*******+++++++++++++++++++++++++++++++++++++
*******+*******+**+++*+++++++++++*+*++++++++++++++++++++++++
+*****+++*****++*++=+++++++*+++++*#%#+++++++++++++++++++++++
+++****+******+*++++++++***#****++#%%+++++++++++++++++++++++
+++++++++++++++++++*++++#**%####+++*%*%%++++++++++++++++++++
++++++++++++++++++*%+*+**#***%#####%#*+*++++++++++++++++++++
+++++++++++++++++**%#*+*#####%##%##***+**+++++++++++++++++++
%%%%#***+++++++++**#%+++*=+*****#++**+++++***+++++++++++++++
*++**#%%%*+**++++*=+##++*%*******###+++++##**+++++++++++++++
+++++++*#+++*****###%%#*##+#++**+=+#**#**#+*******++++++++++
+++++++++******++**%####%%%%@%%##**#*#*++#+*++++**++++++++++
+++++++++++++++**+#%#*##%%%%%#####%%%%%%%*=++*##*+++++++++++
+++++++++++++++++***%#%##***#+++++++++***#%%%#%####*++++++++
++++++++++++++++****%#*+++*##*###*********+*#*+++***########
+++++++++++++++***%#***###################*****+++++++++++++
+++++++++++++++***+#######*++*#################+++++++++++++
++++++++++++++++++##############################**++++++++++
++++++++++++*+++#####################*############*+++++=+++
+++++++*****+++####***#*++##***#####################++++++++
+++++++*++**+*####**########++++***#****#############+++++++