                    ........::.-::::::::::::::::--------::--
                     ........:..-.:::::......::::-:..::::---
                      .......::::-.::::.:::::-:::-::--:-:--=
 .....                .........:.:-.:::..::-::-------:-:-:::
............        ...........::.-:.....:.:::.:::..::::::::
    ........        ............:.:=.....::::.:...:::.:::...
           .         ...  .......::--.......:.....:-:....:..
                    .    .....:::-::=.............:-::......
                    .  ........:::-:=..............::..:.:::
                    . ..........::---:......:....:.::..:.-::
                    .  ........:::----......:....:.::..:.::-
  .......       ....:..  .......::--:=:::..:-....::::::::::-
                 ..::..    ....:.::::---....-.....:----::--:
::::::::::------------------------=-==+=--:.-...:.:------:-:
::.:::::::::-:---------======+===+++**+*++=--::.:..:::::::::
::.::::::::::::-:---------=-======++*++++++==+===-:--:::::::
::.:::::::::::::::----------======++++-++=+=-++=====--------
::.::::::::::::::-----------====--===================-----::
::::::::::::::::::::::::----------========---:--------:::---
..........:::::::::::---------------==-------::::---------::