          .........::.::::::---*+====--=++==++++**##*###**++
       ......  ...::...::::::---*=+=--===---=+++*********#*+
:....   .....  .........:::::---=*-====-===-=*===++**++*****
::---::::....  ............:::---=+:--==--=*+**+*####***#*#*
::----------..............::::----+-:-==-=--++=+++=+++**#***
...::-------.............:::::---::*--=---==--=--==*==+=*++=
..........::.............::::--:::-=+:::::-++=-----*=--=---:
........................::::::------*:.::::-:::----*=---:---
....................:..::::::::::-=:*:...:::-:::--:==-:--===
....................:.::::::::..:-=-+-.::::.=:-:-=-==::=-++=
....................:...::::..:::--:==.:--::+-:----+=--=-++*
.............. .:----:...:.....:::::-+::-=:-+:::--=++*******
.............  ..::--::........:::::::--..::=:::-:=#%%#**%*+
**+*************+******++++===========++---:=:.:-:=####*#**=
**+*+**+*+***+***#**#**####**#****#*#**#*#*==-::-:-=====++*=
+++*+*++*+*+*+**+***#***************#***###**##**+=+++==+++*
*+=*+*++*+*+*+**+***#*************#*##=*#***+########**#****
*++*+*+**+*+****+***#***********+************#****##*******+
**+***+**+*+****+****+**************#####*+++=+*******=++**#
=++++++++++++++++**************++++++++++*+**====**#######*+