......::..::::::............................................
....:..:::::-:-::....:............::::::-::..............:::
....::::.:::.::::-:::::::::.::::::::::-:::--::::......::.::.
.....:::::::..::---:--...............:::-:::-::::....:::....
.....::....:....:---:.                ::::::::.:::.....:::..
.................:::.     .......      ......::.:::.:::.::..
.................:.    . ......          .......:...:::.::..
.......:........:    . ...........        ..:.........:::...
 ......:::....:.      .............      .........:.:.:.....
.............:.      ..............     .............:..:...
.............-.     ...........           ..........:..:....
... .. ...:.:-. .. .............          .........:........
 ...........-: ..  ...........          .......:.:..........
...........:-....  .  ...... .     ... ...................  
 ...:::::::--................................::.::::::::... 
:::::....:--::------:---:-----:-=----------::----------:::..
::::. .:::--::------:---:-----:---:--------::---:----------:
:::::.:::::-::------::--:-----:--::----:---::---:--:::::::::
:::::::::::::::::-----------------------::--:::----:::::::::
..........:::::::::::::::::::-::::::::::::::::::::::......::