            .            ...... ..                ......    
               .    .............:.......................   
           ...................::::::......................  
     .    .   ...........:::::::::...:............:.. ....  
     .    .. .........:::::::::::::::::::............ ....  
 ..  .      ..........::::::::-:::::--:::........  .. ....  
 ......    . ...........::-:::-::::::-:::................   
....:.:.   ..............----:-----:--:::..........   ...   
    ...:. .  ..........::=---------:--:::......... .........
    ........ ........::::+##+==***+===--:..::.....::........
        .............:-...**++===-*+++==-:.=:..:..::.:......
 ...    .... ..............:::::----++-=-:.-:.... .... .....
  ..   ........... .... ...........:-----:.-....:=-:....... 
.................. .................:::--:-=---::-:.........
.................. ..................:::--=:................
.............................:::::::::::--::..... . ..... ..
..........:.....::...::::-----==+====--:::.:............:...
...................::::---------------::::.......:::..:-::.:
...::.............:::::::::----------:::::::::.......:::....
............:.::::::::::--------------------::::::::::::::::