............................:::::..................:.........:................................::..:.....::............................................
................::::::.::::::::::::::::::..:..............:.......................:........:........:.................:...............................
:::.........:::--:::::::::::::::::::::::::::::.........................:..:.............::::::::::...:..........:.:.....:.....:.............:...:.....
...........::::.::::::-::-:::---=----:::::::........:::.:............................:.:::::...::::::::::::........:.......:..............:..........:
.  ......:::.....:::::::::--::--:.::--::::....:..::.:::.:............................:.::::::::::::------::::..::.................:.....:.....:-----::
.........:-::::.:--::::::::...:::::::::::::::--:.:::::::::::::.::::......:..:::::::::::::::::::----:.:::-=:::::---=-......:...............::.:-:::::..
...........::::::-:...:.:--::.......::::-:---::-------::::::::::::::::::::::::::::::::::::-::::--::.:::---==-:.....:-::.........:......:--:::.::.:...:
.................:::.......:::...:--::::--:---::::::--:::::-::::::::..::::::::::::::::::::::::::--::::::::::--:::::::--:..............::::..........::
............:-...:--:--:...:-:.....------=-----::-------:           .......                .:---::::-----::::------:::--:....:......:::..:.::......:::
............:-::::.::::-----:.......::::::-----::::---:.           .. .. .. ......          .:-::::---::--::::---::-::::::.:::.....::...::::..........
............:::::........::--:......::::::-----::----:.           ................   .        .:------::::-----::::::::::::......:.....::.::::........
..............:::..........:.:.:.......:::::----=---..          ...         ....  .            .:-:--::::::::::::::...::::::::........:::::::.:::.....
....:::........::..........:....:::......::::::::-:..           ....................     .       .::....::::::---:.....:::::..........::.::.:::::.::.:
..:..:..:........:.........:.:...:........:.:.::-:.          .. ...................                :............:::::...::::::.......::::....:.:::.::.
........:....:....:.::.......::.....::.....:::-::.        .. .......................    .           ...:........:.::.....:::-::..:::::-::::..::::.....
.:.........:::::......................:......-:.         ....     .............         . .          .............:::...:::..::...::::..::::::::......
...........::......:.........:.............:::         .....   ...................                     ...:..:::..::..:::::..:...:::::::.....:::..:...
...........::.....:.......................::.                 ..............                            ...:...:.....::::...::......:.::.....::::.....
......:......:..::::....................::.         ....   .........................                      ....::....:::.:............:::::::::.....::.
.....:............::...................::.         ....  .... .....................           ..      . .. .:..:......::::............::..............
.. ..............::.......:.:........::..         ...   ...............................               ........:...:......::::::-:....:.::.......::.:..
.   ..............:::::-.:.::.......::.         ...    .................................              .........:.............:::::::::.::.......:..:..
.  ......::::....:...:......:.....-::          ...   ...................................           ..............::::......:.........:...:...::--.....
 .........................:..:::.:::-.         .    ....................................            ..............:...................................
....................::.........:.--.          .   ......................................             ......  .....:....:::.::.....:.:-:...:::::::.....
....  .......:::..::............:--:.            ...............................                     .. ..........:.:.............::...::..-::....... 
.... .........:::......::.......---...   ...    ...............................                       . ...........:....:........:::::...:::..........
.....    .........:::...........---.    ....   . .............................                          ...........::::..............:::::............
.....   ...... ........:..::...---:     .....  .................................                        ......................:-::-:...............  .
......... .. .. ..........:....---....  ..... ....................................                      ............:..........::................ ....
 ........  . ...... ..........:--=.... ..........................................                        ...................::..............:... .....
. ...:...::::::.......... ....----............ .................................                         ............::-:.:--:..............:.........
  ...............  .. .......:---:.........    ..   .................... ..                        ................. .......................:....... .
  .............     .........----.........   ....   .  ................  ..              .....   ................... .......................:... ..  .
................ ............----..........   ...      ................  ..          ........    ................--:..:.....................:......  .
............................:--=:..... ....   ....     ................  ..        ..............................---..............................    
 ........::...::.::::.......=-==. .... ....   ...     .................. ..       .. ....... ....................---......:::::::::........:......    
  .   ....::----------:::::---==--:::. ...:============================--================--------------:::::.....---...:::::------------:::::.....    
........::::---:........::--:--.::----:----------=::::--=--=:-:------=---=-:-:--==--:--:=-:--=:-:--:=---:-::::-----------:--::-----------::::....     
:::::--:----:........::.::--:--:::----:----------=::::--=--=:-:------=-=:=-:-:---=--:--:=----=--:--:----:-::::----------------------------::::::......
:::::---::...........:-:::--:--.::---------------=::::--=--=:-:--:---=:-:=-:-:--==-=:--:=-:--=--:--:----:-:::-----------:-----:---------------------::
::::::::::. .    .::::-:::--:--.:.--------------:-::::--=--=:::--:---=:-:=::-:---=--:--:=-:--=--:--:----:-:::------------:----:------------------:::::
:::::.::::.      .:----:-:--:--.:.-:------------:-::::-:=--=:::------=:-:=::-:---=--::-:=----=--:--:--:-:-::::.:---------:----:--::------:---------:::
::::::::::..  .:::--:--:-:--:--.:.--------------:-::::-:----::::-:----:-:=::::---=--::::=:------:--:--:-:-:::..---------::----:--:--:----:-:::::-:::-:
:::---:-:--:...:::--:--:::--:--.:.----:------:--:-::::-:---=:::--:------:-::::---=:-::-:=-------:--:-::-:--::::---:---:--:----:--::::---::::::::--:-::
-::---::::::::::::---------------------------------------------==---============-------------===---------------------------------------::--::--::--:-:
::::::..............:::.::::::::::::::::::::::::::::::::-:-::::::::::::::-::::::::::::::::::::::::::::::::::::::::::::::::::::-:::::::.:::::::::::::::
.::::::::::::::::::::::-:-----------::::-:------------------------------------------------------------:::----------------------:::::::::::::::::::::::
.........:.....::::::::::::::::::::::::::::::::::::::::::::::::::::::::::-::::-:::::::::::::::::::::::::::::::::::::::::::::::::::::::::..............
.::.:..::::::::::::::::::::::::::::::-:::::::::::::::::::::::::::---::::-----::-::::--:-::::::::::::::::::::::-::::::::::::::::::::::::::::...:.::::::
..............................-.:..::...::::::::::.................:.::.-:....................................:.::::....:...........................::