:::::::..................  ....................                                                            .. ........................................
::::.................      .......................     ......                                               ..........................................
:::...............  ..     ...........................................                                       .   ..  .................................
...............              .     .............................................                                 ...   ...............................
..............             ..      .......................................................                        ....................................
...........                .         ........ .     .......................................                           ................................
....... .                                          ...........................:::::...........                        ................:...............
.......                                           .....................::::-::::-:::::::............                  ................::::..:.........
.....                                          ..............::::::::::::-=-==----=---::::::...........              .................::::............
....                                         .........::::::::------==-===++*+==+=+===-----::::.........            .............::...:::::....:......
...                                         .......::::---------========+++*++++++*+=====-----:::.........           ..........:::.:::::::::::........
..                                        ......::::-----==-========++==+**#*******++=+=====----:::.........          .........::::::::-::::.:.:......
                                        .....::::---================++++*+*#*****+++++++++=====---::.........         ........::::::::----:::::.......
                                    .......::::---====+++++=++++=====++++********++++++++++++====--:::........       .......:::::::::::--:-::::::.....
                                   ......::::---====+++++=--===========+++++*+**+*+++++++++===+===---:::.......     ........:::::::::.------:::.......
                                  .....:::::--===++++++++-==-==============+**+++=++=++++======+====--:::.......    ........::::::::-=:-------:::.....
                                ......::::--==-==+==+++++-::-=---=--========+++++==++++++=====++++++==-::.......     ........:::::::--:--------::.:...
                               .....::::::---=+==*+**+++=++===-=========-==++++++=++++=++++====+++++==--::......     .........:::::::.:--=-:----::::..
                            ......::::---=====+++*+++++===++++===-=====--=========++++=========++=+++===--::.....    ..........    ....:-:-------:::..
              .......      ......::::--=====+++****+++====++++====-====--========--++==+======+=++++=----:::::...                     ::----------:::.
        . ...........    ......:::::--====++++****++++++==+++====-------------=------==============--.:---:.....      .........::::::::.-----------:::
        .............   ......:::::---===+++++***++++++=====---=-------------::------------=---====--=-=--::::....   ..........:::::---.-----------:::
        .............   .....:::::-----====-===-=+++++=====-=:-------::-----------:::::::::::::....::.:::--:.....           ........::-.--:--------:::
           .........   .....::::::---====-=--==+===========:--====+++********++**++++=============-::-----:::....                  :::-:-------------:
                  ..   ....:::::----====-=-=+=-=+==========--===++***#*****++=++*****+=========--=-::--------::....  ..........:::.:::-:--------------
                      .....:::::---====-======-=+==========--=+++**********+++*++++**+++======---=-.:---------:.....................::-:--------------
                     .....::::-----====-=+++==-====-=======--=++*******+****+**+++++*++++======---:.:------::::...       ...::::.:.::.-:----------::-:
                     ....:::------=======++++=-===-========--+++***++************++++**++=====----:.:----:-......           .......::.::--------::::::
                     ....:::::::-=======-===--===--========:-+++*+++++++**####***+++++**+===------:.:----:-::::......            - :..:.:::----:::-:::
                   ......::::-----=============--==========:-++++++++++++*####******++**+=====----:.-----::::::................. - :. :.::::---------:
                  .......:::::-----====+++================-:-==++++==++++++**++++*+++**++=--------:.-::-:::::::.... ............ - :..-.:::--------:-:
                  ......:::::::-----=====+++==============-::.::----:::::::::-:-+++++*++=------.....:::::::::::..... ........... : :.: ........:::----
                   ......::::::::-----===================--:::=+***++++++++**+++==--==+=----:-:.:..=+++==--:::.................. : :.:::........  ....
                    ......::::::::------======-===--=-----:::...:::::...........:::-=:-=------:......:::::::::.................. . ..:::::::--:::.::::
                    .......:::::::::----======------------::::.:::-++:=--==-.+:=**+.:.::-----:::.........:...................... .. ...:...::--===-===
                    .....:.::::::::::---------------------:.::...:---.::--=-.-:-=+-:::...:::::::...................................:...............:::
                    ......::::::::::::::--------:::::::::::::......::.....:.::-:.:.....:.::::::.... ............................ ..:::::----::........
                    .........:..::::::::::::::::::::::.:.:..:............:...:..:.. ............................................  ......:::----:----=-
                    .............::::::::::::::::.................................. .............................................     .........::---=-
                     ...............:::::::::::............................. .                   .....   ..........................:::.   ..  .......:
                      .................:::::::..............:...........::::::::....:..............   ...............................:::::::::........
                        ..................::................   ....................................  .................  ........      ....:::------:..
                         .....................:::::::....:.:..........................  .....::: .. ... ....::................. .......     ....::::::
                      .... ...................::::..:::...:.:-:----:::::::................:.:... .............................. ........:....    .:...
.              ...  ...  .. ...:......:--:::...:==-:....:..:...........................::....................:::..............................:..::...
             .....     .......:........:---...........:.:..:..::.....:...........:........:................:-::................ .................:...:
                    ....:.:.........:--:..:--....:::::::..:::::::...:::::::::::::::::::::.:...............--:................... ..............:-:....
          ...  .   ...........:......::....-:.:.:::.:::.:::..:==:-=-::--:-::::.:::..::.::.............:::::.................:........ ........:::.....
          ..... .............::......:....:.:::.:::.:::::::::.:==:.-=-.....:::..::::::::-::---:.:::.::::--.............:--:..................:-:......
..  ..... .................:-::::::.......:::.::.:=++:::::::::::::-::..:::::::::::::-:---::=+==:::.:::---.:.............................:::::::::.....
.....   ..........---:::.......-=::.......:::::::...::--::::::..::..::.::::::::::::::--:::--===-::.::.::....................:......................:::